#.#######
#.......#
#######.#
# # #....
#########